@@@@@@@@@@@@@@@@@@@@@@@@@@@@@@@@@@@@@@@@@@@@@@@@@@@@@@@@@@@@@@@@@@@@@@@@@@@@@@@@@@@@@@@@@@@@@@@@@@@@@@@@@@@@@@@@@@@@@@@@@@@@@@@@@@@@@@@@@@@@@@@@@@@@@@@@@@@@@@@@@@@@@@@@@@@@@@@@@@@@@@@@@@@@@@@@@@@@@@@@
@@@@@@@@@@@@@@@@@@@@@@@@@@@@@@@@@@@@@@@@@@@@@@@@@@@@@@@@@@@@@@@@@@@@@@@@@@@@@@@@@@@@@@@@@@@@@@@@@@@@@@@@@@@@@@@@@@@@@@@@@@@@@@@@@@@@@@@@@@@@@@@@@@@@@@@@@@@@@@@@@@@@@@@@@@@@@@@@@@@@@@::::::::::::::@@@@
@@@@@@@@@@@@@@@@@@@@@@@@@@@@@@@@@@@@@@@@@@@@@@@@@@@@@@@@@@@@@@@@@@@@@@@@@@@@@@@@@@@@@@@@@@@@@@@@@@@@@@@@@@@@@@@@@@@@@@@@@@@@@@@@@@@@@@@@@@@@@@@@@@@@@@@@@@@@@@@@@@@@@@@@@@@@@@@@@@@@::::::::::::::::@@@@
@@@@@@@@@@@@@@@@@@@@@@@@@@@@@@@@@@@@@@@@@@@@@@@@@@@@@@@@@@@@@@@@@@@@@@@@@@@@@@@@@@@@@@@@@@@@@@@@@@@@@@@@@@@@@@@@@@@@@@@@@@@@@@@@@@@@@@@@@@::::::::::::::::::::::::::::::::::::::::::::::::::::::::::@@@@
@@@@@@@@@@@@@@@@@@@@@@@@@@@@@@@@@@@@@@@@@@@@@@@@@@@@@@@@@@@@@@@@@@@@@@@@@@@@@@@@@@@@@@@@@@@@@@@@@@@@@@@@@@@@@@@@@@@@@@@@@@@@@@@@@@@@@@@@::::::::::::::::::::::::::::::::::::::::::::::::::::::::::::@@@@
@@@@@@@@@@@@@@@@@@@@@@@@@@@@@@@@@@@@@@@@@@::::::::::::::::::::::::::::::::::::::::::::::::::::::::::::::::::::::::::::::::::::::::::::::::::::::::::::::::::::::::::::::::::::::::::::::::::::::::::@@@@
@@@@@@@@@@@@@@@@@@@@@@@@@@@@@@@@@@@@::::::::::::::::::::::::::::::::::::::::::::::::::::::::::::::::::::::::::::::::::::::::::::::::::::::::::::::::::::::::::::::::::::::::::::::::::::::::::::::::@@@@
@@@@@@@@@@@@@@@@@@@@@@@@@@@@@@@@::::::::::::::::::::::::::::::::::::::::::::::::::::::::::::::::::::::::::::::::::::::::::::::::::::::::::::::::::::::::::::::::::::::::::::::::::::::::::::::::::::@@@@
@@@@@@@@@@@@@@@@@@@@@@@@@@@@::::::::::::::::::::::::::::::::::::::::::::::::::::::::::::::::::::::::::::::::::::::::::::::::::::::::::::::::::::::::::::::::::::::::::::::::::::::::::::::::::::::::@@@@
@@@@@@@@@@@@@@@@@@@@@@@@@@::::::::::::::::::::::::::::::::::::::::::::::::::::::::::::::::::::::::::::::::::::::::::::::::::::::::::::::::::::::::::::::::::::::::::::::::::::::::::::::::::::::::::##@@
@@@@@@@@@@@@@@@@@@@@@@@@::::::::::::::::::::::::::::::::::::::::::::::::::::::::::::::::::::::::::::::::::::::::::::::::::::::::::::::::::::::::::::::::::::::::::::::::::::::::::::::::::::::::::::@@@@
@@@@@@@@@@@@@@@@@@@@@@::::::::::::::::::::::::::::::::::::::::::::::::::::::::::::::::::::::::::::::::::::::::::::::::::::::::::::::::::::::::::::::::::::::::::::::::::::::::::::::::::::::::::::::@@@@
@@@@@@@@@@@@@@@@@@@@::::::::::::::::::::::::::::::::::::##############::::::::##########::::::::##################::::::::##::::::::::::::::::::::::::::::::::::::::::::::::::::::::::::::::::::::::@@@@
@@@@@@@@@@@@@@@@@@::::::::::::::::::::::::::::::::::::::::##############::::::::##::::::::::::::::################::::::::##::::::::::::::::::::::::::::::::::::::::::::::::::::::::::::::::::::::::@@@@
@@@@@@@@@@@@@@@@::::::::::::::::::::::::::::######::::::::::::::::::####::::::::::::::::::::::::::::::############::::::::##::::::::::::::::::::::::::::::::::::::::::::::::::::::::::::::::::::::::@@@@
@@@@@@@@@@@@@@##::::::::::::::::::::::::::########::::::::::::::::::::::::::::::::::::::::::::::::::::::########::::::::####::::::::::::::::::::::::::::::::::::::::::::::::::::::::::::::::::::::::@@@@
@@@@@@@@@@@@@@::::::::::::::::::::::::::::########::::::::::::::::::::::::::::::::::::::::::::::::::::::::::::::::::::::####::::::::::::::::::::::::::::::::::::::::::::::::::::::::::::::::::::::::@@@@
@@@@@@@@@@@@##::::::::::::::::::::::::::::::########::::::::::::::::::::::::::::::::::::::::####::::::::::::::::::::::######::::::::::::::::::::::::::::::::::::::::::::::::::::::::::::::::::::::::@@@@
@@@@@@@@@@@@::::::::::::::::::::::::::::::::::######::::::::::::::::::::::::::####::::::::::####::::::::::::::::::::##########::::::::::::::::::::::::::::::::::::::::::::::::::::::::::::::::::::::@@@@
@@@@@@@@@@@@::::::::::::::::::::::::::::::::::::######::::::::::::::::################::::######::::::::::::::::::::::########::::::::::::::::::::::::::::::::::::::::::::::::::::::::::::::::::::::@@@@
@@@@@@@@@@::::::::::::::::::::::::::::::::::::::######::::::::::::::::::::##############::::::::::::::::::::::::::::::::######::::::::::::::::::::::::::::::::::::::::::::::::::::::::::::::::::::::@@@@
@@@@@@@@@@::::::::::::::::::::##::::::::::::::::::##::::::::::::::::::::::::::####::::::::::::::::::::::########::::::::######::::::::::::::::::::::::::::::::::::::::::::::::::::::::::::::::::::::@@@@
@@@@@@@@@@::::::::::::::::::######::::::::::::::::::::::::::::####::::::::::::::::::::::::::::::::::::::::########::::::::::::::::::::::::::::::::::::::::::::::::::::::::::::::::::::::::::::::::::@@@@
@@@@@@@@@@::::::::::::::::::########::::::::::::::::::::::::##########::::::::::::::::::::##::::::::::::::::######::::::::::::::::::::::::::::::::::::::::::::::::::::::::::::::::::::::::::::::::::@@@@
@@@@@@@@@@::::::::::::::::############::::::::::::::::::::##############::::::::::::::::##::::::::::::::::::::####::::::::::::::::::::::::::::::::::::::::::::::::::::::::::::::::::::::::::::::::::@@@@
@@@@@@@@::::::::::::::::::##############::::::::::::######################::::::::::::####::::::::::::::::::::######::::::::::####::::::::::::::::::::::::::::::::::::::::::::::::::::::::::::::::::@@@@
@@@@@@@@::::::::::::::::::##############::::::::::::##########::::::::::####::::::::::####::::::::::::::::::::::##::::::::::######::::::::::::::::::::::::::::::::::::::::::::::::::::::::::::::::::@@@@
@@@@@@@@::::::::::::::::##################::::::::::::######::::::::::::::##::::::::::####::::::::::::##::::::::##::::::::::########::::::::::::::::::::::::::::::::::::::::::::::::::::::::::::::::@@@@
@@@@@@@@::::::::::::::::##################::::::::::::######::::::::::::::##::::::::::######::::::::####::::::::##::::::::############::::::::::::::::::::::::::::::::::::::::::::::::::::::::::::::@@@@
@@@@@@@@::::::::::::::::######::::::::::####::::::::::::####::::::::::::::####::::::::##################::::::::::::::::::##########::::::::::::::::::::::::::::::::::::::::::::::::::::::::::::::::@@@@
@@@@@@@@::::::::::::::::######::::::::::::##::::::::::::::##::::::::::::::####::::::::##############::::::::::::::::::::##########::::::::::::::::::::::::::::::::::::::::::::::::::::::::::::::::@@@@@@
@@@@@@@@::::::::::::::::####::::::::::::::##::::::::::::::::::::::::::::######::::::::::::::::::::::::::::::::::::::::::########::::::::::::::::::::::::::::::::::::::::::::::::::::::::::::::::@@@@@@@@
@@@@@@@@::::::::::::::::####::::::::::::::::##::::::::::::::::::::::::::########::::::::::::::::::::::::::::::::::::::::::::::::::::::::::::::::::::::::::::::::::::::::::::::::::::::::::::::::@@@@@@@@
@@@@@@@@::::::::::::::::##::::::::::::::::::##::::::::::::::::::::::############::::::::::::::::::::::::::::::::::::::::::::::::::::::::::::::::::::::::::::::::::::::::::::::::::::::::::::::::@@@@@@@@
@@@@@@@@::::::::::::::::::::::::::::##::::::####::::::::::::::::::::##############::::::::::::::::::::::::::::::::::::::::::::::::::::::::::::::####::::::::::::::::::::::::::::::::::::::::::::@@@@@@@@
@@@@@@@@::::::::::::::::::::::::::::##::::::##::::::::::::::::::::::::::::########::::::::::::::##::::::::::::::##::::::::::::::::::::::::::::########::::::::::::::::::::::::::::::::::::::::::@@@@@@@@
@@@@@@@@::::::::::::::::::::##::::::##::::::::::::::::::::::::::::::::::::::::::::::::::::::::::####::::::::::::######::::::::::::::::::::::################::::::::::::::::::::::::::::::::::::@@@@@@@@
@@@@@@@@::::::::::::::::######::::::####::::::::::::::::::::::::::::::::::::::::::::::::::::::::####::::::::::######::::::::::::::::::::::######::############::::::::::::::::::::::::::::::::::@@@@@@@@
@@@@@@@@::::::::::::::::######::::::####::::::::::::####::::::::::::::::::::::::::::::::::::::::::::############::::::::::::::::::::::::::::::::::::::::######::::::::##########::::::::::::::::@@@@@@@@
@@@@@@@@::::::::::::::::####::::::######::::::::::########::::::::::::::::::::::::::::####::::::::::::::######::::::::::::::::::::::::::::::::::::::::::::####::::::::##########::::::::::::::::@@@@@@@@
@@@@@@@@::::::::::::::::####::::::########::::::::::##########::::::::::::::::::::::::::######::::::::::::##::::::::::::::::::::::::::::::::::::::::::::::::##::::::::::########::::::::::::::::@@@@@@@@
@@@@@@@@::::::::::::::::##::::::::########::::::::::############::::::::::::::::::::::::::######::::::::::::::::::::::::::::::::::####::::::::::##::::::::::::##::::::::########::::::::::::::::@@@@@@@@
@@@@@@@@::::::::::::::::::::::::::::########::::::::########::::::::::::##::::::::::::::::::::####::::::::::::::::::::::::::::::######::::::####::::::::::::::::##::::::::######::::::::::::::::@@@@@@@@
@@@@@@@@::::::::::::::::::::::::::::::::::::::::::::########::::::::::########::::::::::::::::::######::::::::::::::::::::::::######::::::::####::::::::::::::::##::::::::######::::::::::::::::@@@@@@@@
@@@@@@@@::::::::::::::::##::::::::::::::::::::::::::::::####::::::::##############::::::::::::::::##::::::::::::::::::::::::########::::::::####::::::::::::::::##::::::::######::::::::::::::::@@@@@@@@
@@@@@@@@::::::::::::::::####::::::::::::::::::::::::::::##::::::::::################::::::::::::::::::::::::::::::::::::::##########::::::::####::::::::::::::::##::::::::######::::::::::::::::@@@@@@@@
@@@@@@@@::::::::::::::::::::::######::::::::::::::::::::##::::::::::::::::::::########::::::::::::::::::::::::::::::::::::##########::::::::::######::::::::::::##::::::::######::::::::::::::::@@@@@@@@
@@@@@@@@::::::::::::::::::::::::####::::::::::::::::::::####::::::::::::::::::::::####::::::::::::::::::::::::::::::::::::##########::::::::::::######::::::::::::::::::########::::::::::::::::@@@@@@@@
@@@@@@@@::::::::::::::::::::::::::##::::::::####::::::######::::::::::::::::::::::######::::::::::::::::::::::::::::::::::::##########::::::::::::::::::::::::::::::::::::######::::::::::::::::@@@@@@@@
@@@@@@@@::::::::::::::::::::::::::::::::::::##########::::::::::::::::::::::::::::::####::::::::::::::::::::::::::##::::::::::########::::::::::::::::::::::::::::::::::::::####::::::::::::::::@@@@@@@@
@@@@@@@@::::::::::::::::######::::::::::::::::::::::::::::::::::::::########::::::::::##::::::::::::::::::::::::######::::::::::::::::::::::::::##############::::::::::::::::::::::::::::::::::@@@@@@@@
@@@@@@@@::::::::::::::::########::::::::::::::::::::::::::::::::::::##########::::::::::::::::::::::::::::::::::::####::::::::::::::::::::::::####::::::::##::::::::####::::::::::::::::::::::::@@@@@@@@
@@@@@@@@::::::::::::::::########::::::::::::::::::########::::::::::##########::::::::::::::::::::::::::::::::::::######::::::::::::::::::::::####::::::::::::::::::######::::::::::::::::::::::@@@@@@@@
@@@@@@@@::::::::::::::::########::::::::::::::::::::::######::::::::############::::::::::::::::::::::::::::::::::::########::::::::::::::::::##::::::::::::::::::::::######::::::::::::::::::::@@@@@@@@
@@@@@@@@::::::::::::::::########::::::##::::::::::::::::####::::::::##########::::::::::::::::::::::::::::::::::::::::################::::::::##::::::::::::::::::::::::::::::##::::::::::::::::@@@@@@@@
@@@@@@@@::::::::::::::::########::::::##::::::::::::::::::####::::::########::::::::::::::::::::::::::::::::::::::::::::##############::::::::####::::::::::::::::::::::::::::::::::::::::::::::@@@@@@@@
@@@@@@@@::::::::::::::::########::::::####::::::::::::::::##::::::::######::::::::::::::::::::::::::##::::::::::::::::::::##########::::::::::######::::::::::::::::::::::::::::::::::::::::::::@@@@@@@@
@@@@@@@@::::::::::::::::########::::::::##::::::::::::::####::::::::####::::::::::::::::::::::::::::::##::::::::::::::::::::::::::::::::::::########::::::::########::::::::::::::::::::::::::::@@@@@@@@
@@@@@@@@::::::::::::::::########::::::::####::::::::::::::::::::::::##::::::::::::::::::::::::::::::::::::::::::::::::::::::::::::::::::::############::::::::########::::::::::::::::::::::::::@@@@@@@@
@@@@@@@@::::::::::::::::##########::::::::####::::::::::::::::::::::::::::::::::::::::::::::####::::::::::::::::::::::::::::::::::::::::::############::::::::::######::::::::##::::::::::::::::@@@@@@@@
@@@@@@@@::::::::::::::::##########::::::::########::::::::::::::::::::::::::::::::::::::::########::::::::::::::::::::::::::::::::::::::::::::########::::::::::::####::::::####::::::::::::::::@@@@@@@@
@@@@@@@@::::::::::::::::##########::::::::######################::::::::::::::::::::::::######::######::::::::::::::::::::::::::::::::::::::::::::####::::::::::::::##::::::####::::::::::::::::@@@@@@@@
@@@@@@@@::::::::::::::::::::::::::::::::::####################::::::::::::::::::::::::####::::::::::####::::::::::::::::::::::::::::::::::::::::::::::::::::::::::::::::::::##::::::::::::::::::@@@@@@@@
@@@@@@@@::::::::::::::::::::::::::::::::::::################::::::::::::::::::::::::######::::::::::::##::::::::::::::::::::::::::::::::::::::::::::::::::::::::::::::::::::::::::::::::::::::::@@@@@@@@
@@@@@@@@::::::::::::::::::::::::::::::::::::::::::########::::::::::::::::::::::::::::##::::::::::::::::::::::::::::::::########::::::::::::::::::::::::::##::::::::::::::::::::::::::::::::::::@@@@@@@@
@@@@@@@@::::::::::::::::::::::::::::::::::::::::::::::##::::::::::::::::::::::::::::::::::::::::::::::::::::::::::::::::############::::::::::::::::::::::::::::::::::::::::::::::::::::::::::::@@@@@@@@
@@@@@@@@::::::::::::::::::::::::::::::::::::::::::::::::::::::::::::::::::::::::::::::::::::::::::::::::::::::::::::::::::############::::::::::::::::::::::::::::::::::::::::##::::::::::::::::@@@@@@@@
@@@@@@@@::::::::::::::::::::::::::::::::::::::::::::::::::::::::::::::::::::::::##::::::::::::::::::::::::::::::::::::::::########::::::::::::::::::::::::::::::::::::::::::####::::::::::::::::@@@@@@@@
@@@@@@@@::::::::::::::::::::::::::::::::::::::::::::::::::::::::::::::::########::::::::::::::::::::::::::########::::::::::####::::::::::::::::::::::::::::::::::::::::::::####::::::::::::::::@@@@@@@@
@@@@@@::::::::::::::::::::::::::::::::::::::::::::::::::::::::::::::::########::::::::::::::::::::::##############::::::::::####::::::::::::::##::::::::::::::::##::::::::######::::::::::::::::@@@@@@@@
@@@@::::::::::::::::::::::::::::::::::::::::::::::::::::::::::::::::##########::::::::::::::::::::######::########::::::::::##::::::::::::::::####::::::::::::::################::::::::::::::::@@@@@@@@
@@@@::::::::::::::::::::::::::::::::::::::::::::::::::::::::::::::::########::::::::::##::::::::::##::::::::::######::::::::####::::::::::::::######::::::::::::::##############::::::::::::::::@@@@@@@@
@@@@::::::::::::::::::::::::::::::::::::::::::::::::::::::::::::::::########::::::::####::::::::::::::::::::::######::::::::####::::::::::::########::::::::::::::##############::::::::::::::::@@@@@@@@
@@@@::::::::::::::::::::::::::::::::::::::::::::::::::::::::::::::::::######::::::::######::::::::::::::::::::::####::::::::::####::::::::############::::::::::::##############::::::::::::::::@@@@@@@@
@@@@::::::::::::::::::::::::::::::::::::::::::::::::::::::::::::::::::::##::::::::::######::::::::::::::::::::::##::::::::::::######################::::::::::::::::##########::::::::::::::::::@@@@@@@@
@@@@::::::::::::::::::::::::::::::::::::::::::::::::::::::::::::::::::::::::::::::::::######::::::::::::::::::##::::::::::::::::##############::::::::::::::::::::::##########::::::::::::::::::@@@@@@@@
@@@@::::::::::::::::::::::::::::::::::::::::::::::::::::::::::::::::::::::::::::::::::########::::::::::::::::::::::::::::::::::::::########::::::::::::::::::::::::::########::::::::::::::::@@@@@@@@@@
@@@@::::::::::::::::::::::::::::::::::::::::::::::::::::::::::::::::::::::::::##::::::::########::::::::::::::::::::::::::::::::::::::::::##::::::::::::::::::::::::::::####::::::::::::::::::@@@@@@@@@@
@@@@::::::::::::::::::::::::::::::::::::::::::::::::::::::::::::::::::::::::####::::::::::######::::::::::::::::::::::######::::::::::::::::::::::####::::::::::::::::::::::::::::::::::::::::@@@@@@@@@@
@@@@::::::::::::::::::::::::::::::::::::::::::::::::::::::::::::::::::::::::######::::::::::::::::::::::########################::::::::::::::::########::::::::::::::::::::::::::::::::::::::@@@@@@@@@@
@@@@::::::::::::::::::::::::::::::::::::::::::::::::::::::::::::::::::::::::########::::::::::::::::::::########::::##################::::::::::::##########::::::::::::::::::::::::::::::::@@@@@@@@@@@@
@@@@::::::::::::::::::::::::::::::::::::::::::::::::::::::::::::::::::::::::########::::::::::::::::::::####::::::::::####::::::::::::::##::::::::::##########::::::::::::::::::::::::::::::@@@@@@@@@@@@
@@@@::::::::::::::::::::::::::::::::::::::::::::::::::::::::::::::::::::::::######::::::::::::::::::::::####::::::::::::::::::::::::::::::::::::::::##########::::::::::::::::::::::::::::##@@@@@@@@@@@@
@@@@::::::::::::::::::::::::::::::::::::::::::::::::::::::::::::::::::::::::####::::::::::######::::::::::::::::::::::::::::::::::::::::::::::::::::::########::::::::::::::::::::::::::::@@@@@@@@@@@@@@
@@@@::::::::::::::::::::::::::::::::::::::::::::::::::::::::::::::::::::::::####::::::::##########::::::::::::::::::::::::::::::####::::::::::::::::::######::::::::::::::::::::::::::::@@@@@@@@@@@@@@@@
@@@@::::::::::::::::::::::::::::::::::::::::::::::::::::::::::::::::::::::::####::::::##############::::::::::::::::::::::::::::########::::::::::::::::####::::::::::::::::::::::::::::@@@@@@@@@@@@@@@@
@@@@::::::::::::::::::::::::::::::::::::::::::::::::::::::::::::::::::::::::::##::::::##################::::::::::::::####::::::::##############::::::::::::::::::::::::::::::::::::::@@@@@@@@@@@@@@@@@@
@@@@::::::::::::::::::::::::::::::::::::::::::::::::::::::::::::::::::::::::::##::::::####################::::::##########::::::::##############::::::::::::::::::::::::::::::::::::@@@@@@@@@@@@@@@@@@@@
@@@@::::::::::::::::::::::::::::::::::::::::::::::::::::::::::::::::::::::::::::::::::::::::::::::::::::::::::::::::::::::::::::::::::::::::::::::::::::::::::::::::::::::::::::::@@@@@@@@@@@@@@@@@@@@@@
@@@@::::::::::::::::::::::::::::::::::::::::::::::::::::::::::::::::::::::::::::::::::::::::::::::::::::::::::::::::::::::::::::::::::::::::::::::::::::::::::::::::::::::::::::@@@@@@@@@@@@@@@@@@@@@@@@
@@@@::::::::::::::::::::::::::::::::::::::::::::::::::::::::::::::::::::::::::::::::::::::::::::::::::::::::::::::::::::::::::::::::::::::::::::::::::::::::::::::::::::::::::@@@@@@@@@@@@@@@@@@@@@@@@@@
@@@@::::::::::::::::::::::::::::::::::::::::::::::::::::::::::::::::::::::::::::::::::::::::::::::::::::::::::::::::::::::::::::::::::::::::::::::::::::::::::::::::::::::::@@@@@@@@@@@@@@@@@@@@@@@@@@@@
@@@@::::::::::::::::::::::::::::::::::::::::::::::::::::::::::::::::::::::::::::::::::::::::::::::::::::::::::::::::::::::::::::::::::::::::::::::::::::::::::::::::::::@@@@@@@@@@@@@@@@@@@@@@@@@@@@@@@@
@@@@::::::::::::::::::::::::::::::::::::::::::::::::::::::::::::::::::::::::::::::::::::::::::::::::::::::::::::::::::::::::::::::::::::::::::::::::::::::::::::::::@@@@@@@@@@@@@@@@@@@@@@@@@@@@@@@@@@@@
@@@@::::::::::::::::::::::::::::::::::::::::::::::::::::::::::::::::::::::::::::::::::::::::::::::::::::::::::::::::::::::::::::::::::::::::::::::::::::::::::@@@@@@@@@@@@@@@@@@@@@@@@@@@@@@@@@@@@@@@@@@
@@@@::::::::::::::::::::::::::::::::::::::::::::::::::::::::::::@@@@@@@@@@@@@@@@@@@@@@@@@@@@@@@@@@@@@@@@@@@@@@@@@@@@@@@@@@@@@@@@@@@@@@@@@@@@@@@@@@@@@@@@@@@@@@@@@@@@@@@@@@@@@@@@@@@@@@@@@@@@@@@@@@@@@@@@
@@@@::::::::::::::::::::::::::::::::::::::::::::::::::::::::::@@@@@@@@@@@@@@@@@@@@@@@@@@@@@@@@@@@@@@@@@@@@@@@@@@@@@@@@@@@@@@@@@@@@@@@@@@@@@@@@@@@@@@@@@@@@@@@@@@@@@@@@@@@@@@@@@@@@@@@@@@@@@@@@@@@@@@@@@@
@@@@::::::::::::::::@@@@@@@@@@@@@@@@@@@@@@@@@@@@@@@@@@@@@@@@@@@@@@@@@@@@@@@@@@@@@@@@@@@@@@@@@@@@@@@@@@@@@@@@@@@@@@@@@@@@@@@@@@@@@@@@@@@@@@@@@@@@@@@@@@@@@@@@@@@@@@@@@@@@@@@@@@@@@@@@@@@@@@@@@@@@@@@@@@@@
@@@@::::::::::::::::@@@@@@@@@@@@@@@@@@@@@@@@@@@@@@@@@@@@@@@@@@@@@@@@@@@@@@@@@@@@@@@@@@@@@@@@@@@@@@@@@@@@@@@@@@@@@@@@@@@@@@@@@@@@@@@@@@@@@@@@@@@@@@@@@@@@@@@@@@@@@@@@@@@@@@@@@@@@@@@@@@@@@@@@@@@@@@@@@@@@
@@@@@@@@@@@@@@@@@@@@@@@@@@@@@@@@@@@@@@@@@@@@@@@@@@@@@@@@@@@@@@@@@@@@@@@@@@@@@@@@@@@@@@@@@@@@@@@@@@@@@@@@@@@@@@@@@@@@@@@@@@@@@@@@@@@@@@@@@@@@@@@@@@@@@@@@@@@@@@@@@@@@@@@@@@@@@@@@@@@@@@@@@@@@@@@@@@@@@@@@