@@@@@@@@@@@@@@@
@@:::::::::::@@
@@::::#####::@@
@@:::::::::::@@
@@@@@@@@@@@@@@@