@@@@@@@@@@@@@@@@@@@@@@@@@@@@
@@::::::::::::::::::::::::@@
@@::::::::::::::::::::::::@@
@@::::::::::::::::::::::::@@
@@::::::::::######::::::::@@
@@::::::::::######::::::::@@
@@::::::::::::::::::::::::@@
@@::::::::::::::::::::::::@@
@@::::::::::::::::::::::::@@
@@@@@@@@@@@@@@@@@@@@@@@@@@@@